5
8
00000500
03333330
33333330
33333330
33333332
