5
8
00000500
23333330
33333330
33333330
33333330