10
5
2033333333
0033366633
0063363600
3300503300
3333333300
