10
5
0033333333
0033366633
0063363620
3300503300
3333333300