5
11
00000050033
23333333000
03333333000
03333333000
00003333000
