11
5
00000050033
03333333000
03333333000
03333333000
00023333000
