5
11
00000000033
03333333000
03333333000
03333333000
00023333000