8
6
00333353
20333303
36333303
36666603
00333300
00333300
