8
6
00333363
00333363
36333363
36666563
00333362
00333360
