6
8
33533333
30000000
33330300
33330300
02000000