8
6
33533333
30000000
33330300
33030320
00000000
